#######
# .   #
# $@  #
#  $ .#
#     #
#######

########
#  .   #
# #$## #
# @ $. #
#      #
########

#########
#   #   #
# . $ @ #
#   #   #
#  $ .  #
#########
